00000000000000000000000
0                     0
0 1 1  1  4 4  1  1 1 0
0 1 1  1       1  1 1 0
0 1 1  1   0   1  1 1 0
0 1 1             1 1 0
0                     0
00 11             11 00
0      1       1      0
0      111111111      0
0 1 1  1       1  1 1 0
0 1 1  1   5   1  1 1 0
0 1 1             1 1 0
0 1 1     111     1 1 0
0         1#1         0
00000000000000000000000 